0 0 0 0 0 0 0 0 0 0 0 2 6 6 2 0 0 0 
0 0 0 0 0 0 0 0 0 0 0 2 1 1 2 0 0 0 
0 0 0 0 0 0 0 0 0 0 0 2 1 1 2 0 0 0 
0 0 0 0 0 0 0 0 0 0 0 2 1 1 2 0 0 0 
0 0 0 0 0 2 2 2 2 2 2 2 1 1 2 0 0 0 
0 0 0 0 0 2 1 1 1 1 2 2 2 1 2 0 0 0 
0 0 0 0 0 2 1 1 1 1 1 1 1 1 2 0 0 0 
0 0 0 0 0 2 1 1 2 2 2 2 2 2 2 0 0 0 
0 0 0 0 0 2 1 1 2 0 0 0 0 0 0 0 0 0 
0 0 0 0 0 2 1 5 2 0 0 0 0 0 0 0 0 0 
